O X O X O
G O G E O
O O O O O
X O G O O
O B O O O